2
1
000000000000000000044400000000
000000000000000000044444000000
000000000000000000004003330000
000000000000000000444003330000
000000000000000004440003330000
000000000000000004440000000000
000000000000000004400000000000
000000000000000000000000000000
000000000000000000000000000000
000000000000000000000000000000
000000000000000000000000000000
000000000000000000000000000000
000000000000000000000000000000
000000000000000000001110000000
000000000000000000001110000000
000000000000000000001110000000
000000000220000000000200000000
000000002220000000000200000000
000000000022000000000200000000
000000000002222222222200000000
17 8
3 18