2
2
111111000000000000000000000000
111111100000000000000000000000
111111111033000000000000000000
111111111033000000000000000000
111111100033000000000000000000
011111100333333333333333333333
011111100333333333333333333333
000011000333333333333333333333
000000000333333333333333333333
000333333333333333333333333333
000333333333333333333333333333
000000000333000000000004333333
000000000000000000000004333333
000000000000000000000004333333
000000000000000000000004333333
000000000000000000000004333333
000000000000000000000004333333
000000000000000000000004333333
444444444444400000000004333333
000000000000444444444444333333
2 3
18 0